W______________________________________W
W______________________________________W
W______________________________________W
W1111111111111111111111111111111111111TW
W____________________________________TTW
W_R__________________________________TTW
W_____________________________________TW
W______________________________________W
W______________________________________W
WTT___________________________________TW
WTT___________________________________TW
WTTT_________________________________TTW
WTTT_________________________________TTW
WTT___________________________________TW
WWWWWWWWWWWWWWWWWWWWWWWWWWWWWWWWWWWWWWWW
08