WWWWWWWWWWWWWWWWWWWWWWWWWWWWWWWWWWWWWWWW
W___________TTT________________________W
W______________________________w_______W
W_____________________________www______W
W__________________________wwwwwwww____W
W__________________________wwwwwwwwww__W
W______________________T_T_wwwwwwwww___W
W__T_______________________wwwwwwww____W
W_TT____________________TT__www________W
W1TT11111111111111111111111111111111111W
W_T_________________________TT_________W
W_________________________TTT__________W
W_____________________________T________W
W______________________________________W
WTTT22222222222222222222222222222222TTTW
00