WWWWWWWWWWWWWWWWWWWWWWWWWWWWWWWWWWWWWWWW
_________________________________TTTTTTW
__________________________________TT__TW
______________________________________TW
____________________________________T__W
_______________________________________W
W____________________________________h_W
W__R___________________________________W
W______________________________________W
WTT___________________________________TW
WTT___________________________________TW
WTTT_________________________________TTW
WTTT_________________________________TTW
WTT___________________________________TW
WT_____________________________________W
06