W______________________________________W
W____________________________________RTW
WT____________________________________TW
WT_R_________________________________TTW
WT___________________________________TTW
WTTT_________________________________TTW
WTTT__________________________________TW
WTTT__________________________________TW
WTTT___________________________________W
WTT_____________________________________
WTT_____________________________________
W_______________________________________
W_______R____TTT________________________
W_____TTTTTTTTTTTT___________R__________
WWWWWWWWWWWWWWWWWWWWWWWWWWWWWWWWWWWWWWWW
02