WWWWWWWWWEEEWWWWWWWWWWWWWWWWWWWEEEEEEEWW
________RWWW_________________RRWEEEEWWP_
________________________________WWWW_W__
_____R_______________________________W__
_____________________________________W__
___________________P_________________D__
____________________e________________D__
________________eceeeep______________D__
____________________e________________D__
___________________P_________________D__
_____________________R_______________W__
_____________R_______________________W__
____________RW__________________R____W__
________R_RWWEW______________R_____RWWP_
WWWWWWWWWWWEEEEWWWWWWWWWWWWWWWWWWWWWEEWW
03C