EEEEEEEEWWWWWWWWWWWWWWWWWWWWWWWWWWWWEEEE
EEEEEWWWR___________________________WWEE
EEWWW____________R____________________WE
EEW____________________________________W
EW_________________________________1111W
W__R_____________________________e_1____
WR________________________________e11___
W_____________________________eeeeee1___
EW________________________________e11___
EEW______________________________e_1____
EEEW_______R_______________________1111W
EEWR__________________________________RW
EEEWW_R______________________________WWE
EEEEEWWWW_________________R________WWEEE
EEEEEEEEEWWWWWWWWWWWWWWWWWWWWWWWWWWEEEEE
01C