EEEEEEEEWWWWWWWWWWWWWWWWWWWWWEEEEEEEEEEW
EEEWWWWW_____________________WWWEEEEWWW_
EWWR____________________________WWWW_W__
WR_________R_________________________W__
W____________________________________W__
_________________R_______________e___D__
___________________R______________e__D__
_________________p____________eeeeee_D__
__________________________________e__D__
__________________R______________e___D__
W____________________________________W__
WR___________________________________W__
EWW_____________________W____R_______W__
EEEWR___R_____________WWEWWW________RW__
EEEEWWWWWWWWWWWWWWWWWWEEEEEEWWWWWWWWWWWW
02C