WWWWWWWWWWWWWWWWWWWWWWWWWWWWWWWWWWWWWWWW
_______________________________________W
_______________________________________W
_______________________________________W
WEEEEEEEEEEEEEEEEEEEEEEEEEEEEEEEEE_____W
WEEEEEEEEEEEEEEEEEEEEEEEEEEEEEEEEE_____W
WEEEEEEEEEEEEEEEEEEEEEEEEEEEEEEEEE_____W
WEEEEEEEEEEEEEEEEEEEEEEEEEEEEEEEEE_____W
WEEEEEEEEEEEEEEEEEEEEEEEEEEEEEEEEE_____W
WEEEEEEEEEEEEEEEEEEEEEEEEEEEEEEEEE_____W
WEEEEEEEEEEEEEEEEEEEEEEEEEEEEEEEEE_____W
WEEEEEEEEEEEEEEEEEEEEEEEEEEEEEEEEE_____W
WEEEEEEEEEEEEEEEEEEEEEEEEEEEEEEEEE_____W
WEEEEEEEEEEEEEEEEEEEEEEEEEEEEEEEEE_____W
WWWWWWWWWWWWWWWWWWWWWWWWWWWWWWWWWWP___PW
26P