WWWWWWWWWWWWWWWWWWWWWWWWWWWWWWWWWWWWWWWW
W__________________p___R_______________W
W______________vvRvR__vvv______________W
W______________P__vvR___R______________W
WEEEEEEEEEEEEEEEEEEEEEEEEEEEEEEEEEEEEEEW
WEEEEEEEEEEEEEEEEEEEEEEEEEEEEEEEEEEEEEEW
WEEEEEEEEEEEEEEEEEEEEEEEEEEEEEEEEEEEEEEW
WEEEEEEEEEEEEEEEEEEEEEEEEEEEEEEEEEEEEEEW
WEEEEEEEEEEEEEEEEEEEEEEEEEEEEEEEEEEEEEEW
WEEEEEEEEEEEEEEEEEEEEEEEEEEEEEEEEEEEEEEW
WP___________1______________________2_PW
4____________1______________________2___
4____________1______________________2___
4____________1______________________2___
WWWWWWWWWWWWWWWWWWWWWWWWWWWWWWWWWWWWWWWW
29P