W___WWWWWWWWWWWWWWWWWWWWWWWWWWWWWWWWWWWW
W______________________________________W
W______________________________________W
W______________________________________W
W______________________________________W
W______________________________________W
W______________________________________W
W______________________________________W
W______________________________________W
W______________________________________W
W______________________________________W
W_______________________________________
W_______________________________________
W_______________________________________
WWWWWWWWWWWWWWWWWWWWWWWWWWWWWWWWWWWWWWWW
28P