EEEEEEEEEEEEEEEEEEEEEEEEEEEEEEEEEEEEEEEE
EEEEEEEEEEEEEEEEEEEEEEEEEEEEEEEEEEEEEEEE
EEEEEEEEEEEEEEEEEEEEEEEEEEEEEEEEEEEEEEEE
________________________________________
__P_________________________________P___
________________________________________
________________________________________
eeeeeeeeeeeeeeeeeee_t_eeeeeeeeeeeeeeeeee
________________________________________
________________________________________
__P_________________________________P___
________________________________________
EEEEEEEEEEEEEEEEE_______EEEEEEEEEEEEEEEE
EEEEEEEEEEEEEEEEE_______EEEEEEEEEEEEEEEE
EEEEEEEEEEEEEEEEE_______EEEEEEEEEEEEEEEE
15P