W______________________________________W
W______________________________________W
W_________________________________TT___W
W___T__________________________________W
W__TT__________________________________W
W___________________________________h__W
WTT_www________________________________W
WTTwwwwww______________________________W
WTTwwwww_______________________________W
W_Twwww________________________________W
W___w_R________________________________W
W_________________________________TT___W
W_____________T__________________TTTT__W
W____________TTTT__________________T___W
W______________________________________W
04