W44444444444444444444444444444444444444W
W______________________________________W
W_____________________________2222TT222W
W___T_________________________2________W
W__TT_________________________2________W
W111111111____________________2_____h__W
WTT_www__1____________________2________W
WTTwwwwww1____________________2________W
WTTwwwww_1____________________222222222W
W_Twwww__1_____________________________W
W___w_R__1_____________________________W
W________1________________________TT___W
W________11111T111111111111111111TTTT11W
W____________TTTT__________________T___W
W44444444444444444444444444444444444444W
04