WWWWWWWWWWWWWWWWWWWWWWWWWWWWWWWWWWWWWWWW
WTTTTTT_________________________________
WTTT__R_________________________________
WTTTT_____________T_____________________
WTTTT____________T______________________
WTTT____________TTTR____________________
WTTT_______________________________h___W
WT_____________________________________W
W___h__________________________________W
W_h____________________________________W
W______________________________________W
WT________________________________TT___W
WT_______________________________TTTT__W
WT_________________________________T___W
W11111111111111111111111111111111111111W
05