WWWWWWWWWWWWWWWWWWWWWWWWWWWWWWWWWWWWWWWW
WTTTTTT_________________________________
WTTT____________________________________
WTTTT___________________________________
WTTTT___________________________________
WTTT____________________________________
WTTT_______________________________h___W
WT_____________________________________W
W___h__________________________________W
W_h____________________________________W
W______________________________________W
WT________________________________TT___W
WT____________T__________________TTTT__W
WT___________TTTT__________________T___W
W11111111111111111111111111111111111111W
05