W______________________________________W
WT_____________________________________W
WTT____________________________________W
WTTT__________________________________TW
WTT__________________________R_________W
WTT_R__________________________________W
WTT____________________________________W
WT____________________________________TW
W_____________________________________TW
_____________________________________TTW
________________________________R____TTW
_________________LLLL_____________T__TTW
__________________LLLL____________TTTTTW
___________T_______________R_R__TTTTTTTW
WWWWWWWWWWWWWWWWWWWWWWWWWWWWWWWWWWWWWWWW
03