W______________________________________W
WT_____________________________________W
WTT____________________________________W
WTTT__________________________________TW
WTT__________________________R_________W
WTT_R__________________________________W
WTT____________________________________W
WT____________________________________TW
W_____________________________________TW
_____________________________________TTW
________________________________R____TTW
__________________________________T__TTW
__________________________________TTTTTW
___________T_______________R_R__TTTTTTTW
WWWWWWWWWWWWWWWWWWWWWWWWWWWWWWWWWWWWWWWW