W______________________________________W
W____________________________________TTW
W___ww_R______________________________TW
W_Twwww_______________________________TW
W_Twwwww______________________________TW
W_wwwww________________________________W
W_wwww_________________________________W
W__wR__________________________________W
W______________________________________W
WTT___________________________________TW
WTT___________________________________TW
WTTT_________________________________TTW
WTTT_________________________________TTW
WTT___________________________________TW
WT_____________________________________W
07