W______________________________________
W______________________________________
W______________________________________
W______________________________________
W______________________________________
W______________________________________
W______________________________________
W______________________________________
W______________________________________
W______________________________________
WTTwww_________________________________
WTTwww_________________________________
WTTTTTTTTTTTTTTTTTTTTTTTTTTTTTTTTTTTTTT
WTTTTTTTTTTTTTTTTTTTTTTTTTTTTTTTTTTTTTT
WWWWWWWWWWWWWWWWWWWWWWWWWWWWWWWWWWWWWWW