W______________________________________W
WR__________________________________R__W
W_________________________________T____W
W_____________________________________TW
W_________TT________________________TT_W
W_______TTTww________________________T_W
W______TTTTww________________________T_W
W_______TTTwww_____________________TTT_W
W__________T________________________TT_W
W_____________________________________TW
WT_____________________________________W
WTTT______________________________R____W
WTT_____R___________________________T__W
WTT_T_____________________________TTTT_W
WT_________________________________T___W
01