W_______________________________________
W_______________________________________
W_______________________________________
W_______________________________________
W_______________________________________
W_______________________________________
W_______________________________________
W_______________________________________
W_______________________________________
W_______________________________________
WTTwww__________________________________
WTTwww__________________________________
WTTTTTTTTTTTTTTTTTTTTTTTTTTTTTTTTTTTTTTT
WTTTTTTTTTTTTTTTTTTTTTTTTTTTTTTTTTTTTTTT
WWWWWWWWWWWWWWWWWWWWWWWWWWWWWWWWWWWWWWWW