W______________________________________W
WR__________________________________R__W
W_________________________________T____W
W_____________________________________TW
W_________TT________________________TTTW
W_______TTTww________________________TTW
W______TTTTww________________________T_W
W_______TTTwww_____________________TTR_W
W1111111111T111111111111111111111111TT_W
W______________________________________W
WT_____________________________________W
WTTT______________________________R____W
WTT_____R___________________________T__W
WTT_T_____________________________TTTT_W
WT_________________________________T___W
01