W______________________________________W
W____________________________________R_W
W______________________________________W
W__R___________________________________W
W____________________________R_________W
W______________________________________W
W______________________________________W
W______________________________________W
W______________________________________W
W_______________________________________
W_______________________________________
W__________R____________________________
W_______________________________________
W____________________________R__________
WWWWWWWWWWWWWWWWWWWWWWWWWWWWWWWWWWWWWWWW