________________________________________
__________________________________R_____
_______R________________________________
______R______P___________P______________
________________________________________
_________________p___p__________________
________________________________________
_______________p___t___p________________
________________________________________
_________________p___p________________R_
______R_________________________________
_____________P___________P______________
________________________________________
______________________________R_________
WWWWWWWWWWWWWWWWWWWWWWWWWWWWWWWWWWWWWWWW
10D