_______________________________________W
___P___________________________________W
_______________________________________W
_______________________________________W
______________R_________R___________P__W
_______________________________________W
__________R____________________________W
_______________________________________W
_______________________________________W
_______________________R_______________W
_______________R_______________________W
_______________________________________W
____P_______________________________R__W
___R___________________________________W
WWWWWWWWWWWWWWWWWWWWWWWWWWWWWWWWWWWWWWWW
12D