W_______________________________________
W_______________________________________
W_________________________________R_____
W___R___________________________________
W___________P______________P____________
W_______________________________________
W________________eeeWeee________________
W_____________t__peeWece_p______________
W________________eeeWeee________________
W_______________________________________
W___________P______________P____________
W_______________________________________
W__R____________________________________
WRR_____________________________R_______
WWWWWWWWWWWWWWWWWWWWWWWWWWWWWWWWWWWWWWWW
09D