WWWWWWWWWWWWWWWWWWWWWWWWWWWWWWWWWWWWWWWW
W______________________________________W
W_P__________________________________P_W
W______________________________________W
W______________________________________W
W________________P_____P_______________W
e______________________________________W
e___________________s__________________W
e______________________________________W
e________________P_____P_______________W
e______________________________________W
e______________________________________W
W_P__________________________________P_W
W______________________________________W
WWWWWWWWWWWWWWWWWWWWWWWWWWWWWWWWWWWWWWWW
14P
Romans 8:25
~ But if we hope for what we do not see, we wait for it with patience.