________________________________________
___R____________________________________
____________________________________R___
___________________________R____________
___________P_______________P____________
________________________________________
_____________eeeeeeeeec_________________
_____________e___________t______________
_____________eeeeeeeeep_________________
________________________________________
___________P_______________P____________
______R_________________________________
________________________________________
_________________________________R______
WWWWWWWWWWWWWWWWWWWWWWWWWWWWWWWWWWWWWWWW
11D