WWWWWWWWWWWWWWWWWWWWWWWWWWWWW1111ee1111W
____________R________________1111ee1111W
_______________R______________P_1ee1_P_W
_____________________________e___1e1___W
_______________________________ee_1____W
____________________________________P_WW
_____P3333333P_______________________2DE
_____3_R_t_t_3_______________________2DE
_____3_______3_______________________2DE
_____3_t_t_t_3_______________________2DE
_____P3333333P_______________________2DE
____________________________________PRWW
_______________________R_______________W
_______________________________________W
_______________________________________W
08D