WWWWWWWWWWWWWWWWWWWWWWWWWWWWW1111ee1111W
____________R________________1111ee1111W
_______________R______________P_1ee1_P_W
_____________________________e___1e1___W
_______________________________ee_1____W
_____________________________________P_W
_____P3333333P________________________2D
_____3_R_t_t_3________________________2D
_____3_______3________________________2D
_____3_t_t_t_3________________________2D
_____P3333333P________________________2D
_____________________________________PRW
_______________________R_______________W
_______________________________________W
_______________________________________W
08D