WWWWWWWWWWWEEEEEEEEEEEEEEEEEEEEEEEEEEEEE
W__________EEEEEEEEEEEEEEEEEEEEEEEE___WE
W_eeeeeeeI_EEEEEEEEEEEEEEEEEEEEEEEE_t_WE
W__________EEEEEEEEEEEEEEEEEEEEEEEE___WE
W__________EEEEEEEEEEEEEEEEEEEEEEEEEEEEE
W__________EEEEEEEEEEEEEEEEEEEE_________
____111____EEEEEEEEEEEEEEEEEEEE_________
____1t1____EEEEEEEEEEEEEEEEEEEE_________
____111____EEEEEEEEEEEEEEEEEEEE_________
___________EEEEEEEEEEEEEEEEEEEE_________
___________EEEEEEEEEEEEEEEEEEEEEEEEEEEEE
W__________EEEEEEEEEEEEEEEEEEEEEEEE___WE
W_eeeeeeeI_EEEEEEEEEEEEEEEEEEEEEEEE_t_WE
W__________EEEEEEEEEEEEEEEEEEEEEEEE___WE
WWWWWWWWWWWEEEEEEEEEEEEEEEEEEEEEEEEEEEEE
17P