WWWWWWWWWWWWWWWWWWWWWWWWWWWWWWWWWWWWWWWW
WEEEEEEEEEEE___________________________D
WEEEEEEEEEEE_C_________________________D
WEEEEEEEEEEE___________________________D
WEEEEEEEEEEEEEEEEEEE___EEEEEEEEEEEEEEEEW
WEEEEEEEEEEEEEEEEEEE___EEEEEEEEEEEEEEEEW
WEEE___EEEEEEEEEEEEE___EEEEEEEEEEEEE___W
WEEE_I_EEEEEEEEEEEEE_I_EEEEEEEEEEEEE_t_W
WEEE___EEEEEEEEEEEEE___EEEEEEEEEEEEE___W
WEEE___EEEEEEEEEEEEE_e_EEEEEEEEEEEEEEEEW
WEEE___WWWWWWWWWWWWWWcWWEEEEEEEEEEEEEEEW
W____________________e_________________W
W______________________________________W
W______________________________________W
WWWWWWWWWWWWWWWWWWWWWWWWWWWWWWWP______PW
24P