WWWWWWWWWWWWWWWWWWWWWWWWWWWWWWWWWWWWWWWW
_______________________________________W
_______________________________________W
_______________________________________W
W______________________________________W
W______________________________________W
W______________________________________W
W______________________________________W
W______________________________________W
W______________________________________W
W______________________________________W
W_______________________________________
W_______________________________________
W_______________________________________
WP______PWWWWWWWWWWWWWWWWWWWWWWWWWWWWWWW
26P