WWWWWWWWWWWWWWWWWWWWWWWWWWWWWWWWWWWWWWWW
W______________________________________W
W__________________h___________________W
W______________________________________W
WEEEEEEEEEEEEEEEEEEEEEEEEEEEEEEEEEEEEEEW
WEEEEEEEEEEEEEEEEEEEEEEEEEEEEEEEEEEEEEEW
WEEEEEEEEEEEEEEEEEEEEEEEEEEEEEEEEEEEEEEW
WEEEEEEEEEEEEEEEEEEEEEEEEEEEEEEEEEEEEEEW
WEEEEEEEEEEEEEEEEEEEEEEEEEEEEEEEEEEEEEEW
WEEEEEEEEEEEEEEEEEEEEEEEEEEEEEEEEEEEEEEW
W____________1______________________2__W
4____________1______________________2___
4____________1______________________2___
4____________1______________________2___
WWWWWWWWWWWWWWWWWWWWWWWWWWWWWWWWWWWWWWWW
29P