WWWWWWWWWWWEEEEEEEEEEEEEEEEEEEEEEEEEEEE
W_t________EEEEEEEEEEEEEEEEEEEEEEE___WE
W_peeeeeei_EEEEEEEEEEEEEEEEEEEEEEE_t_WE
W__________EEEEEEEEEEEEEEEEEEEEEEE___WE
W__________EEEEEEEEEEEEEEEEEEEEEEEEEEEE
W__________EEEEEEEEEEEEEEEEEEE_________
___________EEEEEEEEEEEEEEEEEEE_________
___________EEEEEEEEEEEEEEEEEEE_________
___________EEEEEEEEEEEEEEEEEEE_________
___________EEEEEEEEEEEEEEEEEEE_________
___________EEEEEEEEEEEEEEEEEEEEEEEEEEEE
W__________EEEEEEEEEEEEEEEEEEEEEEE___WE
W_peeeeeei_EEEEEEEEEEEEEEEEEEEEEEE_t_WE
W_t________EEEEEEEEEEEEEEEEEEEEEEE___WE
WWWWWWWWWWWEEEEEEEEEEEEEEEEEEEEEEEEEEEE
17P