EEEEEEEEEEEEEEEEE_______EEEEEEEEEEEEEEEE
EEEEEEEEEEEEEEEEE_______EEEEEEEEEEEEEEEE
EPEEEEEEEEEEEEEEE_______EEEEEEEEEEEEEEPE
EEEEEEEEEEEEEEEEE_______EEEEEEEEEEEEEEEE
___________W_________________W_______f__
___________W_________________W_______f__
___________W________p________W_______f__
___________W_________________W_______f__
___________W_________________W_______f__
___________WWWWWWWWWPWWWWWWWWW_______f__
_____________________________________f__
EEE_________________p________________EEE
EPE__________________________________EPE
EEE__________________________________EEE
EEEWWWWWWWWWWWWWWWWWWWWWWWWWWWWWWWWWWEEE
21P