WWWWWWWWWWWEEEEEEEEEEEEEEEEEEEEEEEEEEEEE
W__________EEEEEEEEEEEEEEEEEEEEEEEE___WE
W_eeeeeeeI_EEEEEEEEEEEEEEEEEEEEEEEE_t_WE
W__________EEEEEEEEEEEEEEEEEEEEEEEE___WE
W__________EEEEEEEEEEEEEEEEEEEEEEEEEEEEE
W__________EEEEEEEEEEEEEEEEEEEE_________
___________EEEEEEEEEEEEEEEEEEEE_________
___________EEEEEEEEEEEEEEEEEEEE_________
_____t_____EEEEEEEEEEEEEEEEEEEE_________
___________EEEEEEEEEEEEEEEEEEEE_________
___________EEEEEEEEEEEEEEEEEEEEEEEEEEEEE
W__________EEEEEEEEEEEEEEEEEEEEEEEE___WE
W_eeeeeeeI_EEEEEEEEEEEEEEEEEEEEEEEE_t_WE
W__________EEEEEEEEEEEEEEEEEEEEEEEE___WE
WWWWWWWWWWWEEEEEEEEEEEEEEEEEEEEEEEEEEEEE
17P