WWWWWWWWWWWWWWWWWWWWWWWWWWWWWWWWWWWWWWWW
W______________________________________W
W_P__________________________________P_W
W______________________________________W
W______________________________________W
W________________P_____P_______________W
_______________________________________W
____________________s__________________W
_______________________________________W
W________________P_____P_______________W
W______________________________________W
W______________________________________W
W_P__________________________________P_W
W______________________________________W
WWWWWWWWWWWWWWWWWWWWWWWWWWWWWWWWWWWWWWWW
25P
Ephesians 5:15-16
~ Be very careful, then, how you live--not as unwise but as wise, making the most of every opportunity...