WWWWWWWWWWWWWWWWWWWWWWWWWWWWWWWWWWWWWWWW
WEEEEEEEEEEEEEEEEEEEEEEEEEEEEEEEEEEEEEEE
WEEE________________________________EEEE
WEEE________________________________EEEE
WEEE_________P_________P____________EEEE
W__f________________________________f__E
___f________________________________f__E
___f______________i_________________f__E
___f________________________________f__E
W__f________________________________f__E
WEEE_________P_________P____________EEEE
WEEE________________________________EEEE
WEEE________________________________EEEE
WEEEEEEEEEEEEEEEEEEEEEEEEEEEEEEEEEEEEEEE
WWWWWWWWWWWWWWWWWWWWWWWWWWWWWWWWWWWWWWWW
19P