WEEEEEEEEEEEEEEEEEEEEEEEEEEEEEEEEEEEEEEE
WEEEEEEEEEEEEEEEEEEEEEEEEEEEEEEEEEEEEEEE
WEEEEEEEEEEEEEEEEEEEEEEEEEEEEEEEEEEEEEPE
WEEEEEEEEEEEEEEEEEEEEEEEEEEEEEEEEEEEEEEE
WEEEEEEEEEEEEEEEEEEE____________________
W______PEEEEEEEEEEEE____________________
W_______EEEEEEEEEEEE____________________
W_peeec_EEEEEEEEEEEE_Ieeeeeee___________
W_______EEEEEEEEEEEE____________________
W______PEEEEEEEEEEEE_t__________________
WEEEEEEEEEEEEEEEEEEE____________________
WEEEEEEEEEEEEEEEEEEEEEEEEEEEEEEEEEEEEEEE
WEEEEEEEEEEEEEEEEEEEEEEEEEEEEEEEEEEEEEPE
WEEEEEEEEEEEEEEEEEEEEEEEEEEEEEEEEEEEEEEE
WEEEEEEEEEEEEEEEEEEEEEEEEEEEEEEEEEEEEEEE
20P