WWWWWWWWWWWWWWWWWWWWWWWWWWWWWWWWWWWWWWWW
W______________________________________W
W______________________________________W
W______________________________________W
W______________________________________W
W______________________________________W
W______________________________________W
W______________________________________W
W______________________________________W
W______________________________________W
W______________________________________W
W______________________________________W
W______________________________________W
W______________________________________W
WWWWWWWWWWWWWWWWWWWWWWWWWWWWWWWP______PW
24P