EEEEEEEEEEEEEEEEE_______EEEEEEEEEEEEEEEE
EEEEEEEEEEEEEEEEE_______EEEEEEEEEEEEEEEE
EPEEEEEEEEEEEEEEE_______EEEEEEEEEEEEEEPE
EEEEEEEEEEEEEEEEE_______EEEEEEEEEEEEEEEE
______________D___________D__________f__
______________D___________D__________f__
______________D_____p_____D__________f__
______________D___________D__________f__
______________D___________D__________f__
______________WWWWWWWWWWWWW__________f__
_____________________________________f__
EEE_________________p________________EEE
EPE__________________________________EPE
EEE__________________________________EEE
EEEWWWWWWWWWWWWWWWWWWWWWWWWWWWWWWWWWWEEE
21P