EEEEEEEEEEEEEEEEE_______EEEEEEEEEEEEEEEE
EEEEEEEEEEEEEEEEE_______EEEEEEEEEEEEEEEE
EEEEWWWWWWWWWWWWWdddddddWWWWWWWWWWWWEEEE
EEEE_______________________________WEEEE
EEEE__t_________________________t__WEEEE
___________________________________WEEEE
___________________________________D____
___________________________________D____
___________________________________D____
___________________________________WEEEE
EEEE__t_________________________t__WEEEE
EEEE_______________________________WEEEE
EEEEWWWWWWWWWWWWW_______WWWWWWWWWWWWEEEE
EEEEEEEEEEEEEEEEE_______EEEEEEEEEEEEEEEE
EEEEEEEEEEEEEEEEE_______EEEEEEEEEEEEEEEE
18P