EEEEEEEEEEEEEEEEEEEEEEEEEEEEEEEEEEEEEEEW
EEEEEEEEEEEEEEEEEEEEEEEEEEEEEEEEEEEEEEEW
EEEEEEEEEEEEEEEEEEEEEEEEEEEEEEEEEEEEEEEW
EEEEEEEEEEEEEEEEEEEEEEEEEEEEEEEEEEEEEEEW
_______________________________________W
_______________________________________W
_______________________________________W
__________ecceeeeeeeeeeep______t_______W
____________________e__________________W
____________________p__________________W
_______________________________________W
EEEEEEEEEEEEEEEEEEEEEEEEEEEEEEEEEEEEEEEW
EEEEEEEEEEEEEEEEEEEEEEEEEEEEEEEEEEEEEEEW
EEEEEEEEEEEEEEEEEEEEEEEEEEEEEEEEEEEEEEEW
EEEEEEEEEEEEEEEEEEEEEEEEEEEEEEEEEEEEEEEW
22P