WEEEEEEEEEEEEEEEEEEEEEEEEEEEEEEEEEEEEEEE
WEEEEEEEEEEEEEEEEEEEEEEEEEEEEEEEEEEEEEEE
WEEEEEEEEEEEEEEEEEEEEEEEEEWEEEEEEEEEEEEE
W_________________________W_____________
W_P______________________eceeeeeeeee____
W_________________________W________e____
W___t_____________________W________e____
W_________________________W________eeeee
W___ceeeeeeeeeeeeeep______W_____________
W_________________________W_____________
W_P_______________________W_____________
W_________________________W_____________
WEEEEEEEEEEEEEEEEEEEEEEEEEWEEEEEEEEEEEEE
WEEEEEEEEEEEEEEEEEEEEEEEEEEEEEEEEEEEEEEE
WEEEEEEEEEEEEEEEEEEEEEEEEEEEEEEEEEEEEEEE
14P