WWWWWWWWWWWEEEEEEEEEEEEEEEEEEEEEEEEEEEEE
W__________EEEEEEEEEEEEEEEEEEEEEE___WEEE
W_eeeeeeeI_EEEEEEEEEEEEEEEEEEEEEE_t_WEEE
W__________EEEEEEEEEEEEEEEEEEEEEE___WEEE
W__________EEEEEEEEEEEEEEEEEEEEEEEEEEEEE
W__________EEEEEEEEEEEEEEEEEEEE_________
____111____EEEEEEEEEEEEEEEEEEEE_________
____1t1____EEEEEEEEEEEEEEEEEEEE_________
____111____EEEEEEEEEEEEEEEEEEEE_________
___________EEEEEEEEEEEEEEEEEEEE_________
___________EEEEEEEEEEEEEEEEEEEEEEEEEEEEE
W__________EEEEEEEEEEEEEEEEEEEEEE___WEEE
W_eeeeeeeI_EEEEEEEEEEEEEEEEEEEEEE_t_WEEE
W__________EEEEEEEEEEEEEEEEEEEEEE___WEEE
WWWWWWWWWWWEEEEEEEEEEEEEEEEEEEEEEEEEEEEE
17P