WWWWWWWWWWWWWWWWWWWWWWWWWWWWWWWWWWP___PW
W______________________________________W
W______________________________________W
W______________________________________W
W______________________________________W
W______________________________________W
W______________________________________W
W______________________________________W
W______________________________________W
W______________________________________W
W______________________________________W
W______________________________________W
W______________________________________W
W______________________________________W
W___WWWWWWWWWWWWWWWWWWWWWWWWWWWWWWWWWWWW
27P