EEEEEEEEEEEEEEEEEEEEEEEEEEEEEEEEEEEEEEEW
EEEEEEEEEEEEEEEEEEEEEEEEEEEEEEEEEEEEEEEW
EEEEEEEEEEEEEEEEEEEEEEEEEEEEEEEEEEEEEPEW
____________EEEEEEEEEEEEEEEEEEEEEEEE___W
__________P_EEEEEEEEEEEEEEEEEEEEEEEE_t_W
____________EEEEEEEEEEEEEEEEEEEEEEEE___W
____________EEEEEEEEEEEEEEEEEEEEEEEE___W
eeeeeeeeei__EEEEEEEEEEEEEEEEEEEEEEEE_l_W
____________EEEEEEEEEEEEEEEEEEEEEEEE___W
____________EEEEEEEEEEEEEEEEEEEEEEEEEPEW
__________P_EEEEEEEEEEEEEEEEEEEEEEEEEEEW
____________EEEEEEEEEEEEEEEEEEEEEEEEEEEW
EEEEEEEEEEEEEEEEEEEEEEEEEEEEEEEEEEEEEEEW
EEEEEEEEEEEEEEEEEEEEEEEEEEEEEEEEEEEEEEEW
EEEEEEEEEEEEEEEEEEEEEEEEEEEEEEEEEEEEEEEW
16P