EEEEEEEEEEEEEEEEE_______EEEEEEEEEEEEEEEE
EEEEEEEEEEEEEEEEE_______EEEEEEEEEEEEEEEE
EPEEEEEEEEEEEEEEE_______EEEEEEEEEEEEEEPE
EEEEEEEEEEEEEEEEE_______EEEEEEEEEEEEEEEE
___________D_________________D_______f__
___________D_________________D_______f__
___________D________p________D_______f__
___________D_________________D_______f__
___________D_________________D_______f__
___________WWWWWWWWWWWWWWWWWWW_______f__
_____________________________________f__
EEE_________________p________________EEE
EPE__________________________________EPE
EEE__________________________________EEE
EEEWWWWWWWWWWWWWWWWWWWWWWWWWWWWWWWWWWEEE
21P