WWWWWWWWWWWWWWWWWWWWWWWWWWWWWWWWWWWWWWWW
WR___________________________________D__
W____________________________________D__
W__________R_________________________D__
W____________________________________D__
_________________________________e___D__
__________________________________e__D__
_________________p____________eeeeee_D__
__________________________________e__D__
__________________R______________e___D__
W____________________________________D__
WR___________________________________D__
W____________________________________D__
W___________________________________RD__
WWWWWWWWWWWWWWWWWWWWWWWWWWWWWWWWWWWWWWWW
02D