WWWWWWWWWWWWWWWWWWWWWWWWWWWWWWWWWWWWWWWW
___________________________D___________W
___________________________D___________W
__________P___P____________D___________W
___________________________D___________W
____________p______________D___________W
___________________________D___________W
___________________________D___________W
___________________________D___________W
____________p______________D___e_______W
___________________________D_____e_____W
__________P___P____________D___________W
___________________________D__P__ee__P_W
___________________________D______e____W
WWWWWWWWWWWWWWWWWWWWWWWWWWWWW____ee____W
04D