WWWWWWWWWWWWWWWWWWWWWWWWWWWWWWWWWWWWWWWW
________R____________________RR______WP_
_____________________________________W__
_____R_______________________________W__
_____________________________________W__
___________________P_________________D__
____________________e________________D__
________________eceeeep______________D__
____________________e________________D__
___________________P_________________D__
_____________________R_______________W__
_____________________________________W__
_____________R__________________R____W__
________R__RRRR______________R_____RRWP_
WWWWWWWWWWWWWWWWWWWWWWWWWWWWWWWWWWWWWWWW
03C