WWWWWWWWWWWWWWWWWWWWWWWWWWWWW____ee____W
_________________________________ee____W
______________________________P__ee__P_W
_____________________________e____e____W
_______________________________ee______W
_______________________________________W
_______________________________________W
_______________________________________W
_______________________________________W
_______________________________________W
_______________________________________W
_______________________________________W
_______________________________________W
_______________________________________W
WWWWWWWWWWWWWWWWWWWWWWWWWWWWWWWWWWWWWWWW
05D