WWWWWWWWWWWWWWWWWWWWWWWWWWWWWWWWWWWWWWWW
W____________________________________R_W
W______________________________________W
W______________________________________W
W__________________________________1111W
W__R_____________________________e_1____
W_________________________________e11___
W_____________________________eeeeee1___
W_________________________________e11___
W________________________________e_1____
W__________R_______________________1111W
W______________________________________W
W______________________________________W
W_____________________________________RW
WWWWWWWWWWWWWWWWWWWWWWWWWWWWWWWWWWWWWWWW
01D