EEEEWWWWWWWWWWWWWWWWWWWWWWWWWWWWWWWWEEEE
EEEWR_______________________________WWEE
EWW______________R____________________WE
W______________________________________W
W__________________________________1111W
W__R_____________________________e_1____
W_________________________________e11___
W_____________________________eeeeee1___
W_________________________________e11___
W________________________________e_1____
W__________R_______________________1111W
WR____________________________________RW
EW____R______________________________WWE
EEWWW_____________________R________WWEEE
EEEEEWWWWWWWWWWWWWWWWWWWWWWWWWWWWWWEEEEE
01C