WWWWWWWWWWWWWWWWWWWWWWWWWWWWWWWWWWWWWWWW
_____________________________________DP_
_____________________________________D__
_____R_______________________________D__
_____________________________________D__
___________________P_________________D__
____________________e________________D__
________________eceeeep______________D__
____________________e________________D__
___________________P_________________D__
_____________________R_______________D__
_____________________________________D__
_____________________________________D__
_____________________________________DP_
WWWWWWWWWWWWWWWWWWWWWWWWWWWWWWWWWWWWWWWW
03D