WWWWWWWWWWWWWWWWWWWWWWWWWWWWWWWWWWWWWWWW
WEEEEEEEEEEEEEEEEEEEEEEEEEEEEEEEEEEEEEEW
WEEE________________________________EEEW
WEEE________________________________EEEW
WEEE_________P_________P____________EEEW
W__f________________________________f___
___f________________________________f___
___f______________I_________________f___
___f________________________________f___
W__f________________________________f___
WEEE_________P_________P____________EEEW
WEEE________________________________EEEW
WEEE________________________________EEEW
WEEEEEEEEEEEEEEEEEEEEEEEEEEEEEEEEEEEEEEW
WWWWWWWWWWWWWWWWWWWWWWWWWWWWWWWWWWWWWWWW
19P