WWWWWWWWWWWWWWWWWWWWWWWWWWWWWWWP______PW
WEEEEEEEEEEEEEEEEEE___EEEEEEEEE________W
WEEEEEEEEEEEEEEEEEE_t_EEEEEEEEE________W
WEEEEEEEEEEEEEEEEEE_e_EEEEEEEEE________W
W________EEEEEEEEEEEEEEEEEEEEEE________W
_________EEEEEEEEEEEEEEEEEEEEEE________W
_________EEEEEEEEEEEEEEEEEEEEEE________W
_________EEEEEEEEEEEEEEEEEEEEEE________W
_________EEEEEEEEEEEEEEEEEEEEEE________W
_________EEEEEEEEEEEEEEEEEEEEEE________W
W________EEEEEEEEEEEEEEEEEEEEEEEEEEEEEEW
W_________________________EEEEEEEE___EEW
W_________________peeeeeI_EEEEEEEE_t_EEW
W_________________________EEEEEEEE___EEW
WWWWWWWWWWWWWWWWWWWWWWWWWWWWWWWWWWWWWWWW
23P