WWWWWWWWWWWWWWWWWWWWWWWWWWWWWWWWWWWWWWWW
W______________________________________W
W______________________________________W
W_______________________________________
W______________________________________W
W______________________________________W
W______________________________________W
W______________________________________W
W______________________________________W
W________P_____________________________W
W______________________________________W
W______________________________________W
W______________________________________W
W______________________________________W
WWWWWWWWWWWWWWWWWWWWWWWWWWWWWWWWWWWWWWWW
00D