WWWWWWWWWWWWWWWWWWWWWWWWWWWWWWWWWWWWWWWW
W______________________________________W
W_P__________________________________P_W
W_______________________________________
W______________________________________W
W______________________________________W
W______________________________________W
W___________________s__________________W
W______________________________________W
W______________________________________W
W______________________________________W
W______________________________________W
W_P__________________________________P_W
W______________________________________W
WWWWWWWWWWWWWWWWWWWWWWWWWWWWWWWWWWWWWWWW
10P
Proverbs 16:16
~"How much better to get wisdom than gold, to get insight rather than silver!"