EEEEEEEEEEEEEEEEEEEEEEEEEEEEEEEEEEEEEEEE
EEEEEEEEEEEEEEEEEEEEEEEEEEEEEEEEEEEEEEEE
WWWWWWWWWWWWWWWWWWWWWWWWWWWWEEEEEEEEEEEE
________111___111_______R_PWEEEEEEEEEEEE
________1t1eee1t1_________PWEEEEEEEEEEEE
________111___111_R_______4WWWWWWWWWWWWW
_________e_____e____e__eee4DEEEEEEEEEEEE
_________e_____e__e___eeee4DEEEEEEEEEEEE
_________e_____e_____ee_e_4DEEEEEEEEEEEE
________111___111_________4WWWWWWWWWWWWW
________1t1eee1t1________RPWEEEEEEEEEEEE
____R___111___111_______RRPWEEEEEEEEEEEE
WWWWWWWWWWWWWWWWWWWWWWWWWWWWEEEEEEEEEEEE
EEEEEEEEEEEEEEEEEEEEEEEEEEEEEEEEEEEEEEEE
EEEEEEEEEEEEEEEEEEEEEEEEEEEEEEEEEEEEEEEE
11D