WWWWWWWWWWWWWWWWWWWWWWWWWWWWWWWWWWWWWWWW
__________________________________R_____
________R_______________________________
________P_____________________P_________
________________________________________
___________________t____________________
__________p_________________p___________
________________________________________
________________________________________
___________________p____________________
________________________________________
________PR____________________P_________
_____________________________R__________
________________________________________
________________________________________
07D