WWWWWWWWWWWWWWWWWWWWWWWWWWWWWWWWWWWWWWWW
W_______________________________________
W_P___________________________________P_
W_______________________________________
W___ee__________________________________
W___ee_p________________________________
W_______________________________________
W____p__________________________________
W_______________________________________
W_______________________________________
W_______________________________________
W_______________________________________
W_______________________________________
W_P_____________________________________
W_______________________________________
01D