EEEEEEEEEEEEEEEEEEEEEEEEEEEEEEEEEEEEEEEE
EEEEEEEEEEEEEEEEEEEEEEEEEEEEEEEEEEEEEEEE
WWWWWWWWWWWWWWWWWWWWWWWWWWWWEEEEEEEEEEEE
________111___111_________PWEEEEEEEEEEEE
________1P1___1P1_________PWEEEEEEEEEEEE
________111___111_R_______2WWWWWWWWWWWWW
__________________________2T____________
__________________________2T____________
__________________________2T____________
________111___111_________2WWWWWWWWWWWWW
________1P1___1P1_________PWEEEEEEEEEEEE
____R___111__R111_________PWEEEEEEEEEEEE
WWWWWWWWWWWWWWWWWWWWWWWWWWWWEEEEEEEEEEEE
EEEEEEEEEEEEEEEEEEEEEEEEEEEEEEEEEEEEEEEE
EEEEEEEEEEEEEEEEEEEEEEEEEEEEEEEEEEEEEEEE
11D