2222222222222222222222222222222222222222
2____________________________________R_2
2______________________________________2
2______________________________________2
2______________________________________2
2__R________111111111111111____________2
2___________1_____________1____________2
2___________1_____________1____________2
2___________1_____________1____________2
2___________111111111111111____________2
2__________R___________________________2
2______________________________________2
2______________________________________2
2_____________________________________R2
2222222222222222222222222222222222222222
05D