_______________________________________W
_______________________________________W
_______________________________________W
_______________________1111111111111111W
_______________________1_______________W
_______________________1_______________W
_______________________1_____________P_W
_______________________1___eeeeeeeeee__W
_______________________1___eeee22eeee__W
_______________________1___ece2222epe__W
_______________________1___eeee22eeee__W
_______________________1___eeeeeeeeee__W
_______________________1__P__________P_W
_______________________1_______________W
WWWWWWWWWWWWWWWWWWWWWWWWWWWWWWWWWWWWWWWW
09D