_______________________________________W
______________________________________RW
_______R_______________________________W
____________________R__1111111111111111W
_______________________1_______________W
_______________________1_______________W
_______________________1__P__________P_W
_______________________1___eeee__eeee__W
_______________________1___ecee22eepe__W
_______________________1___eeee22eeee__W
_______________________1___eeee22eeee__W
_______________________1___eeeeeeeeee__W
________R______________1__P__________P_W
_______________________1_____________R_W
WWWWWWWWWWWWWWWWWWWWWWWWWWWWWWWWWWWWWWWW
09D