W_______________________________________
W_______________________________________
W________________________R______________
WR________________________P___P_________
W_______________________________________
W__________P444P____________p___________
W__________4___4________________________
W__________4_l_4__________P___PR________
W__________4___4________________________
W_____R____P444P________________________
W____________________t__________________
W_RR_____________________________R______
W__R____________________________________
WR_____________R________________________
WWWWWWWWWWWWWWWWWWWWWWWWWWWWWWWWWWWWWWWW
03D