WWWWWWWWWWWWWWWWWWWWWWWWWWWWWWWWWWWWWWWW
W_______R_______________________________
W_P111P111P_____________________________
W_1_______1_____________________________
W_1_p___p_1__________________________R__
W_1_______1_____________________________
W_P111P111P_____________________________
W_______________________________________
W_______________________________________
W_______________________________________
W_R_____________________________________
W_______________________________________
W_______________________________________
W________________________________R______
W_______________________________________
01D