_______________________________________W
______________________________________RW
_______R__111111111111111111___________W
__________1________________1___________W
__________1________________1_______R___W
__________1__P__________P__1_________RRW
__________1___eee____eee___1__________RW
__________1___ece2__2epe___t___________W
__________1___eee2222eee___1___________W
__________1___eeeeeeeeee___1___________W
__________1___eeeeeeeeee___1___________W
__________1__P__________P__1__R________W
__________1________________1___________W
_________R1________________1___________W
WWWWWWWWWWWWWWWWWWWWWWWWWWWWWWWWWWWWWWWW
09D