________________________________________
________________________________________
_______________________________R________
________________________________________
________________________________________
____________R___________________________
________________________________________
___________________P____________________
________________________________________
________________________________________
________________________________________
________________________________________
________________________________R_______
_____R________P___P_____________________
WWWWWWWWWWWWWWWWWWWWWWWWWWWWWWWWWWWWWWWW
06D