WWWWWWWWWWWWWWWWWWWWWWWWWWWWWWWWWWWWWWWW
4______________________________________W
4_____11111______________________P___P_W
4_____1___1____________________________W
4_____1_t_1________________________t___W
4_____1___1____________________________W
4_____11111__________________________P_W
4______________________________________W
4______________________________________W
4______________________________________W
4______________________________________W
4______________________________________W
4______________________________________W
4______________________________________W
444444444444444444444444444444444444444W
07D