WEEEEEEEEEEEEEEEEEEWWWWWWWWWWWWWWWWWWWWW
WEEEEEEEEEEEEE11111_______________R_____
WR11EEEEEEE111_____________________P____
W___11EE111_____________________________
W_____11________________________________
W__________________________e____________
W_______________________________________
W_______________________________________
W__________________e____________________
W_______________________________________
WR_______________________e______________
W_______________________________________
W____P____________________________RP____
W_______________________________________
W_______________e_______________________
05D