W_______________________________________
W_______________________________________
W________________________R______________
WR________________________P___P_________
W_______________________________________
W___________________________p___________
W_______________________________________
W_________________________P___PR________
W_P111P_________________________________
W_1___1_________________________________
W_1_l_1_________________________________
W_1___1__________________________R______
W_P111P_________________________________
W______________R________________________
WWWWWWWWWWWWWWWWWWWWWWWWWWWWWWWWWWWWWWWW
03D