WWWWWWWWWWWWWWWWWWWWWWWWWWWWWWWWWWWWWWWW
____________________________________R___
___R_R__________________________________
________________________________________
______R_________________________________
________________________________________
________________________________________
________________________________________
________________________________________
______________________________R_________
______________________________PR________
________________________________R_______
________________________________________
________R_______________________________
________________________________________
04D