WWWWWWWWWWWWWWWWWWWWWWWWWWWWWWWWWWWWWWWW
_________RR______________________R______
________________________________________
________________________________________
________________________________________
_______________P_________P______________
_____________________111________________
__________________t__1l1________________
_____________________111________________
_______________P_________P______________
________________________________________
________________________________________
___R___________________________R________
______R_________________________________
________________________________________
06D