WWWWWWWWWWWWWWWWWWWWWWWWWWWWWWWWWWWWWWWW
4_R_______________________________R___RW
4_____________________________________RW
4__________________R___________________W
4______________________________________W
4______P111P________________P___P______W
4______1___1___________________________W
4______1_t_1_eeeeeeeeeeeeee___t________W
4______1___1___________________________W
4______P111P________________P___P______W
4______________________________________W
4_R____________________________________W
4____________________________R_________W
4______________________________________W
444444444444444444444444444444444444444W
07D