EEEEEEEEEEEEEEEEEEEEEEEEEEEEEEEEEEEEEEEE
EEEEEEEEEEEEEEEEEEEEEEEEEEEEEEEEEEEEEEEE
WWWWWWWWWWWWWWWWWWWWWWWWWWWWEEEEEEEEEEEE
________111___111_________PWEEEEEEEEEEEE
________1t1___1t1_________PWEEEEEEEEEEEE
________111___111_R_______4WWWWWWWWWWWWW
__________________________4T____________
__________________________4T____________
__________________________4T____________
________111___111_________4WWWWWWWWWWWWW
________1t1___1t1_________PWEEEEEEEEEEEE
____R___111__R111_________PWEEEEEEEEEEEE
WWWWWWWWWWWWWWWWWWWWWWWWWWWWEEEEEEEEEEEE
EEEEEEEEEEEEEEEEEEEEEEEEEEEEEEEEEEEEEEEE
EEEEEEEEEEEEEEEEEEEEEEEEEEEEEEEEEEEEEEEE
11D