WWWWWWWWWWWWWWWWWWWWWWWWWWWWWWWWWWWWWWWW
4_R_______________________________R___RW
4_____P111P______________________P___PRW
4_____1___1________R___________________W
4_____1_t_1________________________t___W
4_____1___1____________________________W
4_____P111P______________________P___P_W
4______________________________________W
4______________________________________W
4______________________________________W
4______________________________________W
4_R____________________________________W
4____________________________R_________W
4______________________________________W
444444444444444444444444444444444444444W
07D