WWWWWWWWWWWWWWWWWWWWWWWWWWWWWWWWWWWWWWWW
W_______R_______________________________
W_______________________________________
W_______________________________________
W____________________________________R__
W_______________________________________
W________P111P111111111111P111P_________
W________1____________________1_________
W________1_p________t_______p_1_________
W________1____________________1_________
W_R______P111P111111111111P111P_________
W_______________________________________
W_______________________________________
W________________________________R______
W_______________________________________
01D