WWWWWWWWWWWWWWWWWWWWWWWWWWWWWWWWWWWWWWWW
W_______________________________________
W________t___________________t__________
F_______________________________________
W_______________________________________
W_______________________________________
W_______________________________________
W________________________ww_____________
W____________________wwwwwwww___________
W__________________wwwwwwwwwww__________
W__________________wwwwwwwwwww__________
W__________________wwwwwwwwww___________
W___________________wwwwwwwww___________
W_______________________________________
W_______________________________________
13P