WWWWWWWWWWWWWWWWWWWWWWWWWWWWWWWWWWWWWWWW
W_______________________________________
W_______________________________________
F_______________________________________
W_______________________________________
W_______________________________________
W_______________________________________
W___eeeWeee_____________________________
W___eceWepe_____________________________
W___eeeWeee_____________________________
W_______________________________________
W_______________________________________
W____________________________________P__
W_______________________________________
W______________________________________W
13P