W______________________________________W
W_______________________________________
W__P_________________________________P__
W_______________________________________
W_______t_______________________t_______
W_________l___________________l_________
W_______________________________________
W___________________t___________________
W_______________________________________
W_________l___________________l_________
W_______t_______________________t_______
W_______________________________________
W__P_________________________________P__
W_______________________________________
WWWWWWWWWWWWWWWWWWWWWWWWWWWWWWWWWWWWWWWW
15P