W______________________________________W
W______________________________________W
W______________________________________W
W__________________p___________________W
W__________________e___________________W
W1P________________e___________________W
__1________________e___________________W
__1________________ceeep_______________W
__1________________e___________________W
W1P________________e___________________W
W__________________e___________________W
W__________________p___________________W
W______________________________________W
W______________________________________W
W______________________________________W
14P