WWWWWWWWWWWWWWWWWWWWWWWWWWWWWWWWWWWWWWWW
W_______________________________________
W_______________________________________
F_______________________________________
W_______________________________________
W_______________________________________
W_______________________________________
W_______________________________________
W_______________________________________
W_______________________________________
W_______________________________________
W_______________________________________
W____________________________________P__
W_______________________________________
W______________________________________W
13P