WWWWWWWWWWWWWWWWWWWWWWWWWWWWWWWWWWWWWWWW
W_______________________________________
W_______________________________________
F_______________________________________
W_______________________________________
W_______________________________________
W_______________________________________
W_______________________________________
W_______________________________________
W_______________________________________
W_______________________________________
W_______________________________________
W_______________________________________
W_______________________________________
W_______________________________________
13P