WWWWWWWWWWWWWWWWWWWWWWWWWWWWWWWWWWWWWWWW
W______________________________44444____
W______________________________4EEE4____
F______________________________4ECE4____
W______________________________4EEE4____
W______________________________44444____
W_______________________________________
W___eeeWeee_____________________111_____
W___eceWepe_____________________1t1_____
W___eeeWeee_____________________111_____
W_______________________________________
W_______________________________________
W____________________________________P__
W_______________________________________
W______________________________________W
13P