W______________________________________W
W_______________________________________
W____________________________________P__
W_______________________________________
W_______________________________________
W_______________________________________
W_______________________________________
W_______________________________________
W_______________________________________
W_______________________________________
W_______________________________________
W_______________________________________
W_______________________________________
W_______________________________________
WWWWWWWWWWWWWWWWWWWWWWWWWWWWWWWWWWWWWWWW
15P