WWWWWWWWWWWWWWWWWWWWWWWWWWWWWWWWWWWWWWWW
W__________R___________________________W
W________________t_p_____tt__R_________W
W_____________P__________t_____________W
W______________________________________W
W_______________________________________
W_______________________________________
W_______________________________________
W_______________________________________
W_______________________________________
W______________________________________W
W______c_______________________________W
W______________________________________W
W______________________________________W
WWWWWWWWWWWWWWWWWWWWWWWWWWWWWWWWWWWWWWWW
17P