W______________________________________W
W______________________________________W
W______________________________________W
W__________________p___________________W
W__________________e___________________W
W_P________________e___________________W
___________________e___________________W
___________________ceeep_______________W
___________________e___________________W
W_P________________e___________________W
W__________________e___________________W
W__________________p___________________W
W______________________________________W
W______________________________________W
W______________________________________W
14P