WWWWWWWWWWWWWWWWWWWWWWWWWWWWWWWWWWWWWWWW
_______________________________________W
_______________________________________W
_______________________________________W
_______________________________________W
_______________________________________W
_______________________________________W
_______________________________________W
_______________________________________W
_______________________________________W
_______________________________________W
_______________________________________W
__P____________________________________W
_______________________________________W
W______________________________________W
19P