W______________________________________W
_______________________________________W
__P____________________________________W
_______________________________________W
_______________________________________W
_______________________________________W
_______________________________________W
_______________________________________W
_______________________________________W
_______________________________________W
_______________________________________W
_______________________________________W
_______________________________________W
_______________________________________W
WWWWWWWWWWWWWWWWWWWWWWWWWWWWWWWWWWWWWWWW
21P