WWWWWWWWWWWWWWWWWWWWEEEEEEEEEEEEEEEEEEEE
___________________RWWWWEEEEEEEEEEEEEEEE
________________________WWEEEEWWEEEEEEEE
__________P___P___________WWWW__WWEEEEEE
____________________R______W______WWEEEE
____________p______________W________WEEE
___________________________D_________WEE
___________________________D__________WE
___________________________D___________W
____________p______________W___e_______W
__________________________WW_____e_____W
__________P___P__________WEW___________W
________________________WEEEW_P__ee__P_W
______________________RWEEEEEW____e____W
WWWWWWWWWWWWWWWWWWWWWWWEEEEEEW___ee____W
04C